0 0 0 R 0 0

0 b 0 0 0 0

B 0 0 0 0 r

0 Y 0 0 0 0

0 0 0 0 0 0

0 0 y 0 0 0