0 0 0 0 0 0

0 0 0 0 0 0

0 y 0 0 0 0

R b 0 0 0 0

0 0 0 0 0 Y

r 0 B 0 0 0